+---------------------~----------------------+
|        @        @     1   @        @       |
| #@# # #@# #@# # # # # # # # #@# # # # # # #|
|   @   @      @        @       @   @     @  |
|# #@# # #@# # # # #@# # # # #@# # # # # # # |
|   @     @      @            @         @    |
| # # #@# #@#@# # # # # # #@# # # # #@# # # #|
|      @     @       @       @        @      |
|# #@# # #@# # # # # #@# # # # #@# # #@# #@# |
|      @         @     @            @        |
| # # #@# # # #@# # # # #@# # # #@# # # #@# #|
|   @      @    @      @        @    @   @   |
+---------------------~----------------------+