+---------------------~----------------------+
|                     P                      |
|                                            |
|                                            |
|                                            |
|                                            |
|                      E                     |
|                                            |
|                                            |
|                                            |
|                                            |
|                                            |
+---------------------~----------------------+