+---------------------~----------------------+
|        @        @   P     @        @       |
| #@# # #@# #@# # # # # # # # #@# # # # # # #|
|   @   @      @        @       @   @     @  |
|# #@# # #@# # # # #@# # # # #@# # # # # # # |
|   @     @      @            @         @    |
| # # #@# #@#@# # # # #E# #@# # # # #@# # # #|
|      @     @       @       @        @      |
|# #@# # #@# # # # # #@# # # # #@# # #@# #@# |
|      @         @     @            @        |
| # # #@#E# # #@# # # # #@# # # #@# # # #@# #|
|   @      @    @      @        @    @   @   |
+---------------------~----------------------+