+---------------------~-----------------------------------+
|        @        @   P     @          @   @     @        |
| #@# # #@# #@# # # # # # # # #@# # ## # # # # # # #@# # #|
|   @B  @   @  @        @       @   @        @     B @   @|
|# #@# # #@# # # # #@# # # # #@# # #  # #@# # # # #@# # # |
|  E@     @      @            @     B @            @      |
| # # #@# #@#@# # # # #E# #@# # # # ## # # #E# #@# # # # #|
|      @     @       @     @ @            @     @ @       |
|# #@# # #@# # # # # #@# # # # #@# #B # # #@# # # # #@# # |
|      @     B   @     @    @@        @     @    @@       |
| # # #@#E# # #@# # # # #@# # # #@# ## # # # #@# # # #@#B#|
|E  @      @    @      @        @    @      @        @    |
+---------------------~--------------------~--------------+