+---------------------~-----------------------+
|    B   @        @   P     @          @   BB |
| #@# # #@# #@# # # # # # # # #@# # ## #@# # #|
|   @   @   @  @        @       @  B@    @   @|
|# #@# # #@# # # # #@# # # # #@# # #  # # # # |
|  V@     @      @            @       @       |
| # # #@# #@#@# # # # #E# #@# # # # ## # # #B#|
+---------------------~-----------------------+
100