+---------------------~-----------------------+
|        @        @   P     @          @   B  |
| #@# # #@# #@# # # # # # # # #@# # ## #@# # #|
|   @   @   @  @        @       @   @    @   @|
|# #@# # #@# # # # #@# # # # #@# # #  # # # # |
|  V@     @      @            @       @       |
| # # #@# #@#@# # # # #V# #@# # # # ## # # #B#|
+---------------------~-----------------------+
0