+---------------------~-----------------------+
|        @       P@   P     @          @   B  |
| #@# # #@# #@# # # # # # # # #@# # ## #@# # #|
|   @   @   @  @        @       @   @    @   @|
|# #@# # #@# # # # #@# # # # #@# # #  # # # # |
|  V@     @      @            @       @       |
| # # #@# #@#@# # # # #V# #@# # # # ## # # #B#|
+---------------------~-----------------------+
100