###############################
~ P #     @           #  #    #
#  ####  ####  #  #  #  ####  #
#        #  #  #  #  #        #
#  #  ####  ####  #  #  #  ####
#  #        #  #  #     #     #
#######  ####  #######  #  ####
#                 #     #     #
#  #  #  #######  #######  ####
#  #  #     #           #  #  #
#  ####  #  #  ####  #  #  #  #
#     #  #  #     #  #  #     #
#  ####  #########  #######  ##
############################~##
0