+---------------------~-----------------------+
|            @     @ #P#    @    #P#        B |
|            @     @  #     @     #           |
|VVVVVVVVVVVV@VVVVV@@@@@@@@@@ EEEEEEEEE       |
|            @     @ B      @                 |
|  EEEEEEEEEE@EEEEE@EEEEEEEE@E                |
|            @     @   E    @              B  |
+---------------------~-----------------------+
0