+---------------------~----------------------+
|                     P                      |
| # # # # # # # # # # # # # # # # # # # # # #|
|                                  E         |
|# # # # # # # # # # # # # # # # # # # # # # |
|                                            |
| # # # # # # # # # # #E# # # # # # # # # # #|
|                                            |
|# # # # # # # # # # # # # # # # # # # # # # |
|                                            |
| # # # #E# # # # # # # # # # # # # # # # # #|
|                             E              |
+---------------------~----------------------+