+---------------------~-----------------------+
|                    #P#                   B  |
|                     #                       |
|                             EEEEEEEEE       |
|                    B                        |
|  EEEEEEEEEEEEEEEEEEEEEEEEEEE                |
|                      E                   B  |
+---------------------~-----------------------+
0