+-------+
|P    #E|
|   @  #|
|   @   |
+-------+
100