+---------------------~----------------------+
|                                            |
|                      P                     |
|                                            |
|                                            |
|                                            |
|                                            |
|          P                                 |
|                                            |
|                                            |
|                                            |
|                                            |
+---------------------~----------------------+