+---------------------~----------------------+
|                                            |
|                      P                     |
|                                   ##       |
|  #####                             #       |
|                                  ###       |
|                                    #       |
|          P                         #       |
|                                            |
|                     B                      |
|##BBBBBBBBBBBBBBBBBBBBBBBBBBBBBBBBBBBBBBBB##|
|E##BBBBBBBBBBBBBBBBBBBBBBBBBBBBBBBBBBBBBBB#E|
+---------------------~----------------------+
200